O O O O O O O O O O O O O O O O O O O O
O O O O O O O O O O O O O O O O O O O O
O O O O O O O O O O O G G G G G F G O O
O O O O O O O O O O O G O O O O O G O O
O O O O O O O O O O O G O O O O O G O O
O O O O O O O O O O O G O O 0 O O G O O
O O O O O O O O O O O G O O O O O G O O
O O O O O O O O O O O G O O O O O G O O
O O O O O O O O O O O G G G G G G G O O
O O O O O O O O O R O O O O O O O O O O
O G G G G G G G O O O O O O O O O O O O
O G O O O O O G O O O O O O O O O O O O
O G O O O O O G O O O O O O O O O O O O
O G O O 1 O O G O O O O O O O O O O O O
O G O O O O O G O O O O O O O O O O O O
O G O O O O O G O O O O O O O O O O O O
O G F G G G G G O O O O O O O O O O O O
O O O O O O O O O O O O O O O O O O O O
O O O O O O O O O O O O O O O O O O O O
O O O O O O O O O O O O O O O O O O O O
